....................
....................
...........#........
.....###..###.......
...........#........
.....###..###.......
...........#........
.....###..###.......
...........#........
.....###..###.......
...........#........
.....###..###.......
...........#........
.....###..###.......
...........#........
.....###..###.......
...........#........
.....###..###.......
...........#........
....................
