....................
.......###..........
......#####.........
.......###..........
........#...........
....................
....................
....................
....................
....................