----------------------
|                    |
|                    |
|                    |
|                    |
| ###############    |
|                ### |
|                   #|
|                    |
|                    |
----------------------