....................
....................
....................
....................
....................
....#...............
...###..............
....................
.....#..............
....###.............
....................
.......#............
......###...........
....................
.........#..........
..........###.......
....................
.............#......
..............###...
....................
