....................
....................
....................
....................
.###############....
................###.
...................#
....................
....................