....................
....................
....................
........#...........
..###...............
........#...........
..###...............
........#...........
..###...............
........#...........
..###...............
........#...........
..###...............
........#...........
..###...............
........#...........
..###...............
........#...........
..###...............
....................
